1111111111111
100100C000C01
1000011111001
1P0011E1C0001
1111111111111