1111111111111
100100C0000C1
1110011111001
1P1011E000C01
1111111111111