1111111111111
10010001P0EC1
1000011111111
1000110000001
1111111111111