1111111111111
1P0C0E0000C01
1P00011111001
1P0011E0000E1
1111111111111