11111111111111111111111111111111111111111111
10010000000000001000000001000000000000000001
10000111110011000011111001011110001100001111
1P00110E0000110001100000010000011000011000C1
10000111110011000011111001011110001100001111
1000011111001100C011111001011110001100001111
10000111110000000011111001011110000000001111
100C00000100110000000010010010000011000000C1
11110001111111111111000000000000000001111111
10000111110011000011111001011110001100001111
10000000000011000011111001011110000000001111
10000111110000000011111001011110000000001111
100000000100110000000010010010000011000000C1
11111111111111111111111111111111111111111111