1111111111111
1P11000000001
1000011111001
100011CE00001
1111111111111