1111111111111
1P110000001C1
1000011101111
100011E000001
1111111111111