1111111111111
1P110000000C1
1000011111001
100011E100001
1111111111111