1111111111111
1C01000000001
1111011111001
1P0001E000001
1111111111111
