1111111111111
1P110000000C1
10p0011111001
100011E000001
1111111111111